abbaubare	abbaubar
abbaubarem	abbaubar
abbaubaren	abbaubar
Abbaubaren	Abbaubare
abbaubarer	abbaubar
abbaubarere	abbaubar
abbaubarerem	abbaubar
abbaubareren	abbaubar
Abbaubareren	Abbaubarere
abbaubarerer	abbaubar
abbaubareres	abbaubar
abbaubares	abbaubar
abbaubarste	abbaubar
abbaubarstem	abbaubar
abbaubarsten	abbaubar
Abbaubarsten	Abbaubarste
abbaubarster	abbaubar
abbaubarstes	abbaubar
abbaue	abbauen
Abbauen	abbauen
abbauend	abbauen
abbauende	abbauend
abbauendem	abbauend
abbauenden	abbauend
Abbauenden	Abbauende
abbauender	abbauend
abbauendes	abbauend
Abbauens	Abbauen
abbauest	abbauen
abbauet	abbauen
Abbaus	Abbau
abbaust	abbauen
abbaut	abbauen
abbaute	abbauen
Abbauten	Abbau
abbauten	abbauen
Abbauten	abbauen
abbautest	abbauen
abbautet	abbauen
abbehält	abbehalten
abbehalte	abbehalten
Abbehalten	abbehalten
abbehaltend	abbehalten
abbehaltende	abbehaltend
abbehaltendem	abbehaltend
abbehaltenden	abbehaltend
Abbehaltenden	Abbehaltende
abbehaltender	abbehaltend
abbehaltendes	abbehaltend
abbehaltene	abbehalten
abbehaltenem	abbehalten
abbehaltenen	abbehalten
Abbehaltenen	Abbehaltene
abbehaltener	abbehalten
abbehaltenes	abbehalten
Abbehaltens	Abbehalten
abbehaltest	abbehalten
abbehaltet	abbehalten
abbehältst	abbehalten
abbehielt	abbehalten
abbehielte	abbehalten
abbehielten	abbehalten
abbehieltest	abbehalten
abbehieltet	abbehalten
abbeiße	abbeißen
Abbeißen	abbeißen
abbeißend	abbeißen
abbeißende	abbeißend
abbeißendem	abbeißend
abbeißenden	abbeißend
Abbeißenden	Abbeißende
abbeißender	abbeißend
abbeißendes	abbeißend
Abbeißens	Abbeißen
abbeißest	abbeißen
abbeißet	abbeißen
abbeißt	abbeißen
abbeize	abbeizen
Abbeizen	abbeizen
abbeizend	abbeizen
abbeizende	abbeizend
abbeizendem	abbeizend
abbeizenden	abbeizend
Abbeizenden	Abbeizende
abbeizender	abbeizend
abbeizendes	abbeizend
Abbeizens	Abbeizen
abbeizest	abbeizen
abbeizet	abbeizen
abbeizt	abbeizen
abbeizte	abbeizen
abbeizten	abbeizen
abbeiztest	abbeizen
abbeiztet	abbeizen
abbekam	abbekommen
abbekäme	abbekommen
abbekamen	abbekommen
abbekämen	abbekommen
abbekämest	abbekommen
abbekämet	abbekommen
abbekamst	abbekommen
abbekamt	abbekommen
abbekomme	abbekommen
Abbekommen	abbekommen
abbekommend	abbekommen
abbekommende	abbekommend
abbekommendem	abbekommend
abbekommenden	abbekommend
Abbekommenden	Abbekommende
abbekommender	abbekommend
abbekommendes	abbekommend
abbekommene	abbekommen
abbekommenem	abbekommen
abbekommenen	abbekommen
Abbekommenen	Abbekommene
abbekommener	abbekommen
abbekommenes	abbekommen
Abbekommens	Abbekommen
abbekommest	abbekommen
abbekommet	abbekommen
abbekommst	abbekommen
abbekommt	abbekommen
abberief	abberufen
abberiefe	abberufen
abberiefen	abberufen
abberiefest	abberufen
abberiefet	abberufen
abberiefst	abberufen
abberieft	abberufen
abberufe	abberufen
Abberufen	abberufen
abberufend	abberufen
abberufende	abberufend
abberufendem	abberufend
abberufenden	abberufend
Abberufenden	Abberufende
abberufender	abberufend
abberufendes	abberufend
abberufene	abberufen
abberufenem	abberufen
abberufenen	abberufen
Abberufenen	Abberufene
abberufener	abberufen
abberufenes	abberufen
Abberufens	Abberufen
abberufest	abberufen
abberufet	abberufen
abberufst	abberufen
abberuft	abberufen
abbestelle	abbestellen
Abbestellen	abbestellen
abbestellend	abbestellen
abbestellende	abbestellend
abbestellendem	abbestellend
abbestellenden	abbestellend
Abbestellenden	Abbestellende
abbestellender	abbestellend
abbestellendes	abbestellend
Abbestellens	Abbestellen
abbestellest	abbestellen
abbestellet	abbestellen
abbestellst	abbestellen
abbestellt	abbestellen
abbestellte	abbestellen
Abbestellte	abbestellen
abbestellte	abbestellt
abbestelltem	abbestellt
abbestellten	abbestellen
Abbestellten	abbestellen
abbestellten	abbestellt
Abbestellten	Abbestellte
abbestellter	abbestellt
abbestelltes	abbestellt
abbestelltest	abbestellen
abbestelltet	abbestellen
abbete	abbeten
Abbeten	abbeten
abbetend	abbeten
abbetende	abbetend
abbetendem	abbetend
abbetenden	abbetend
Abbetenden	Abbetende
abbetender	abbetend
abbetendes	abbetend
Abbetens	Abbeten
abbetest	abbeten
abbetet	abbeten
abbetete	abbeten
abbeteten	abbeten
abbetetest	abbeten
abbetetet	abbeten
abbettele	abbetteln
Abbetteln	abbetteln
abbettelnd	abbetteln
abbettelnde	abbettelnd
abbettelndem	abbettelnd
abbettelnden	abbettelnd
Abbettelnden	Abbettelnde
abbettelnder	abbettelnd
abbettelndes	abbettelnd
Abbettelns	Abbetteln
abbettelst	abbetteln
abbettelt	abbetteln
abbettelte	abbetteln
abbettelten	abbetteln
abbetteltest	abbetteln
abbetteltet	abbetteln
abbettle	abbetteln
abbezahle	abbezahlen
Abbezahlen	abbezahlen
abbezahlend	abbezahlen
abbezahlende	abbezahlend
abbezahlendem	abbezahlend
abbezahlenden	abbezahlend
Abbezahlenden	Abbezahlende
abbezahlender	abbezahlend
abbezahlendes	abbezahlend
Abbezahlens	Abbezahlen
abbezahlest	abbezahlen
abbezahlet	abbezahlen
abbezahlst	abbezahlen
abbezahlt	abbezahlen
abbezahlte	abbezahlen
Abbezahlte	abbezahlen
abbezahlte	abbezahlt
abbezahltem	abbezahlt
abbezahlten	abbezahlen
Abbezahlten	abbezahlen
abbezahlten	abbezahlt
Abbezahlten	Abbezahlte
abbezahlter	abbezahlt
abbezahltes	abbezahlt
abbezahltest	abbezahlen
abbezahltet	abbezahlen
abbiege	abbiegen
Abbiegen	abbiegen
abbiegend	abbiegen
abbiegende	abbiegend
abbiegendem	abbiegend
abbiegenden	abbiegend
Abbiegenden	Abbiegende
abbiegender	abbiegend
abbiegendes	abbiegend
Abbiegens	Abbiegen
Abbiegern	Abbieger
Abbiegers	Abbieger
abbiegest	abbiegen
abbieget	abbiegen
abbiegst	abbiegen
abbiegt	abbiegen
Abbilde	Abbild
abbilde	abbilden
Abbilde	abbilden
Abbilden	abbilden
abbildend	abbilden
abbildende	abbildend
abbildendem	abbildend
abbildenden	abbildend
Abbildenden	Abbildende
abbildender	abbildend
abbildendes	abbildend
Abbildens	Abbilden
Abbilder	Abbild
Abbildern	Abbild
Abbildes	Abbild
abbildest	abbilden
abbildet	abbilden
abbildete	abbilden
abbildeten	abbilden
abbildetest	abbilden
abbildetet	abbilden
Abbilds	Abbild
Abbildungen	Abbildung
abbinde	abbinden
Abbinden	abbinden
abbindend	abbinden
abbindende	abbindend
abbindendem	abbindend
abbindenden	abbindend
Abbindenden	Abbindende
abbindender	abbindend
abbindendere	abbindend
abbindenderem	abbindend
abbindenderen	abbindend
Abbindenderen	Abbindendere
abbindenderer	abbindend
abbindenderes	abbindend
abbindendes	abbindend
abbindendste	abbindend
abbindendstem	abbindend
abbindendsten	abbindend
Abbindendsten	Abbindendste
abbindendster	abbindend
abbindendstes	abbindend
Abbindens	Abbinden
abbindest	abbinden
abbindet	abbinden
abbiß	abbeißen
abbisse	abbeißen
abbissen	abbeißen
abbissest	abbeißen
abbisset	abbeißen
abbißt	abbeißen
abbitte	abbitten
Abbitte	abbitten
Abbitten	Abbitte
Abbitten	abbitten
abbittend	abbitten
abbittende	abbittend
abbittendem	abbittend
abbittenden	abbittend
Abbittenden	Abbittende
abbittender	abbittend
abbittendes	abbittend
Abbittens	Abbitten
abbittest	abbitten
abbittet	abbitten
abblase	abblasen
Abblasen	abblasen
abblasend	abblasen
abblasende	abblasend
abblasendem	abblasend
abblasenden	abblasend
Abblasenden	Abblasende
abblasender	abblasend
abblasendes	abblasend
Abblasens	Abblasen
abblasest	abblasen
abblaset	abblasen
abblasse	abblassen
Abblassen	abblassen
abblassend	abblassen
abblassende	abblassend